lllllglllll
lllllllllll
ll-------ll
ll-------ll
ll-------ll
ll--sss--ll
ll--sas--ll
ll--sss--ll
ll-------ll
lllllllllll
lllllllllll